house -> houses
cat -> cats
bus -> buses
marsh -> marshes
lunch -> lunches
tax -> taxes
blitz -> blitzes
truss -> trusses
city -> cities
puppy -> puppies
boy -> boys
ray -> rays
wolf -> wolves
wife -> wives
potato -> potatoes
tomato -> tomatoes
fantasy -> fantasies
policy -> policies
trophy -> trophies
day -> days
galaxy -> galaxies
journey -> journeys
case -> cases
codec -> codecs
performance -> performances
chache -> chaches
shelf -> shelves
knife -> knives
self -> selves
thief -> thieves
dish -> dishes
abcsf -> abcsves
abcsg -> abcsgs
inch -> inches
abcf -> abcves
abchy -> abchies
abchf -> abchves
abcfh -> abcfhs
abcyy -> abcyies
abcfy -> abcfies
abces -> abceses
abcfs -> abcfses
abcfc -> abcfcs
abcyf -> abcyves
abcef -> abceves
abcfe -> abcves
abcyfe -> abcyves
absshchxzoffeydy -> absshchxzoffeydies
abc23 -> FAIL
abc#sdf -> FAIL